CSRobot	KEYWORD1
setSpeed	KEYWORD2
driveForward	KEYWORD2
driveBackwards	KEYWORD2
stop	KEYWORD2
driveFeet	KEYWORD2
turnRight	KEYWORD2
turnLeft	KEYWORD2
turnAroundRight	KEYWORD2
turnAroundLeft	KEYWORD2
setBrightness	KEYWORD2
displayColor	KEYWORD2
turnLightOff	KEYWORD2
buttonOnePressed	KEYWORD2
buttonTwoPressed	KEYWORD2
lightLevel	KEYWORD2
RED	LITERAL1
GREEN	LITERAL1
BLUE	LITERAL1
WHITE	LITERAL1
YELLOW	LITERAL1
PURPLE	LITERAL1
